# Part 3
# This is a continuation of the remuneracoes_buscaComposicoesBasesFolha section
 do empréstimo (Type: Long)
- parcela: Parcela (Type: Integer)
- totalParcela: Total de parcelas (Type: Integer)
- valorTotal: Valor total (Type: BigDecimal)
- numeroContrato: Número do contrato (Type: String)
- razaoSocial: Razão social (Type: String)
- valorLancado: Valor lançado (Type: BigDecimal)
- valorParcela: Valor da parcela (Type: BigDecimal)
- observacao: Observação (Type: String)
- isEmprestimoRh:  (Type: Boolean)
## Evento
- id: Id (Type: Long)
- tipo: Tipo do evento (Type: )
- configuracaoEventoId: Identificador da configuração do evento (Type: Long)
- classificacaoEvento: Classificação do evento (Type: )
- lancamentoVariavel: Se é lançado por variável (Type: Boolean)
- lancamentoEvento: Lançamento de variável  (Type: LancamentoEvento)
- valorReferencia: Valor de referência (Type: BigDecimal)
- valorCalculado: Valor calculado (Type: BigDecimal)
- codigoEvento: Código do evento (Type: Long)
- descricaoEvento: Descrição do evento (Type: String)
- replicado: Indica se é uma réplica (Type: Boolean)
- folhaId: Identificador da folha (Type: Long)
- parametrosEvento: Dados do evento vigente na competência da folha (Type: ConfiguracaoEvento)
- isDemonstrarParcela:  (Type: Boolean)
- parcelasEvento: Dados da parcela paga no evento (Type: ParcelaEventoDto)
## PagamentoAnterior
- id: Identificador (Type: Long)
- contemRra: Contém RRA? (Type: Boolean)
- pagamentoParcelado: Pagamento foi parcelado? (Type: Boolean)
- remuneracaoSalarialDevidaSucessora: Remuneração salárial é devida pela sucessora (Type: Boolean)
- tipoPagamento: Tipo de pagamento anterior (Type: )
- competenciaDevida: Competencia devida (Type: YearMonth)
- dataAssinatura: Data de assinatura (Type: LocalDate)
- origemPagamentoAnterior: Origem do pagamento anterior (Type: String)
- tipoProcessoRRA: Tipo de processo RRA (Type: )
- numeroProcessoRRA: Número do processo RRA (Type: String)
- descricaoRRA: Descrição do RRA (Type: String)
- valorDespesasCustoJudicial: Valor das despesas com custo judicial (Type: BigDecimal)
- valorTotalDespesasAdvogados: Valor total das despesas com advogados (Type: BigDecimal)
- tipoSelecaoMatricula: Tipo de seleção de matrícula (Type: )
- restringirMatriculasLista: Restringir as matrículas a lista? (Type: Boolean)
## RemuneracaoComEventosFonteDados
- id: Id (Type: Long)
- codigoMatricula: Codigo da matrícula (Type: CodigoMatriculaFonteDadosMinhaFolha)
- matricula: Matrícula (Type: MatriculaRemuneracao)
- tipoProcessamento: Tipo de processamento (Type: )
- subTipoProcessamento: Subtipo de processamento (Type: )
- competencia: Competência (Type: YearMonth)
- dataPagamento: Data de pagamento (Type: LocalDate)
- dataFechamento: Data de fechamento (Type: LocalDate)
- totalBruto: Total bruto (Type: BigDecimal)
- totalDesconto: Total dos descontos (Type: BigDecimal)
- identificadorFolhaDePagamento: Identificador da folha de pagamento (Type: String)
- totalAvosAdquiridos: Total de avos adquiridos 13º (Type: Long)
- saldoFgts: Saldo FGTS (Type: BigDecimal)
- valorLiquido: Valor líquido (Type: BigDecimal)
- eventos: Eventos (Type: Evento)
- abatimentoInss: Abatimento INSS (Type: BigDecimal)
- totalBaseCalculoFundoAssist: Total base Calc